111111111111111
1000100000100C1
100000001000001
1P0001111E00001
1000000C1000001
100000001000001
1000000000000C1
111111111111111