1111111111111111111111
100010000C100000000001
1000000010000000110001
1P00E11110000010110001
1000000010000010110001
10000000100000100C0001
100C000000000000000001
1111111111111111111111