1111111111111111111111111111111111
100010000C1000000000000000011100C1
1000000010000000110001000001100001
1P0001000000001E110001000001000001
100C010000000000000001000000000001
1111111111111111111111111111111111